ESSSSSSSSSSSSSSSSSSSSSSSES
SSSSSSSSSSSSSSSSSSSSSSSSSS
SSWWSSWWSSWWSSWWSSWWSSWWSS
SSWWSSWWSSWWSSWWSSWWSSWWSS
SSWWSSWWSSWWSSWWSSWWSSWWSS
SSWWSSWWSSWWSSWWSSWWSSWWSS
SSWWSSWWSSWWZZWWSSWWSSWWSS
SSWWSSWWSSWWZZWWSSWWSSWWSS
SSWWSSWWSSWWSSWWSSWWSSWWSS
SSWWSSWWSSSSSSSSSSWWSSWWSS
SSWWSSWWSSSSSSSSSSWWSSWWSS
SSSSSSSSSSWWUSWWSSSSSSSSSS
SSSSSSSSSSWWSSWWSSSSSSSSSS
SSSSWWWWSSSSSSSSSSWWWWSSSS
ZZSSWWWWSSSSSSSSSSWWWWSSZZ
SSSSSSSSSSWWSSWWSSSSSSSSSS
SSSSSSSSSSWWWWWWSSSSSSSSSS
SSWWSSWWSSWWWWWWSSWWSSWWSS
SSWWSSWWSSWWSSWWSSWWSSWWSS
SSWWSSWWSSWWSSWWSSWWSSWWSS
SSWWSSWWSSWWSSWWSSWWSSWWSS
SSWWSSWWSSSSSSSSSSWWSSWWSS
SSWWSSWWSSSSSSSSSSWWSSWWSS
SSWWSSWWSSSWWWWSSSWWSSWWSS
SSSSSSSSSSSWBSWSSSSSSSSSSS
SSSSSSSSSSSWSSWSSSSSSSSSSS

